20 20
500 500
8 8 8 8 8 8 8 8 8 8 8 8 8 8 8 8 8 8 8 8
10 0 1 2 3 4 5 6 7 8 9 10 11 12 13 14 15 16 17 9
10 18 1 1 1 1 1 1 1 1 1 1 1 1 1 1 1 1 1 9
10 1 1 1 1 1 1 1 1 1 1 1 1 1 1 1 1 1 1 9
10 1 1 1 1 1 1 1 1 1 1 1 1 1 1 1 1 1 1 9
10 1 1 1 1 1 1 1 1 1 1 1 1 1 1 1 1 1 1 9
10 1 1 1 1 1 1 1 1 1 1 1 1 1 1 1 1 1 1 9
10 1 1 1 1 1 1 1 1 1 1 1 1 1 1 1 1 1 1 9
10 1 1 1 1 1 1 1 1 1 1 1 1 1 1 1 1 1 1 9
10 1 1 1 1 1 1 1 1 1 1 1 1 1 1 1 1 1 1 9
10 1 1 1 1 1 1 1 1 1 1 1 1 1 1 1 1 1 1 9
10 1 1 1 1 1 1 1 1 1 1 1 1 1 1 1 1 1 1 9
10 1 1 1 1 1 1 1 1 1 1 1 1 1 1 1 1 1 1 9
10 1 1 1 1 1 1 1 1 1 1 1 1 1 1 1 1 1 1 9
10 1 1 1 1 1 1 1 1 1 1 1 1 1 1 1 1 1 1 9
10 1 1 1 1 1 1 1 1 1 1 1 1 1 1 1 1 1 1 9
10 1 1 1 1 1 1 1 1 1 1 1 1 1 1 1 1 1 1 9
10 1 1 1 1 1 1 1 1 1 1 1 1 1 1 1 1 1 1 9
10 1 1 1 1 1 1 1 1 1 1 1 1 1 1 1 1 1 1 9
10 11 11 11 11 11 11 11 11 11 11 11 11 11 11 11 11 11 11 11
WoodshopSaw 250 200 0
WoodshopSaw 1000 1000 0
AreaSwitch 250 500 2
Teacher 400 400 0
WoodenTable 600 600 0