76 55
1000 900
0 0 0 0 0 0 0 0 0 0 0 0 0 0 0 0 0 0 0 0 0 0 0 0 0 0 0 0 0 0 0 0 0 0 0 0 0 0 0 0 0 0 0 0 0 0 0 0 0 0 0 0 0 0 0 0 0 0 0 0 0 0 0 0 0 0 0 0 0 0 0 0 0 0 0 0 
0 0 0 0 0 0 0 0 0 0 0 0 0 0 0 0 0 0 0 0 0 0 0 0 0 0 0 0 0 0 0 0 0 0 0 0 0 0 0 0 0 0 0 0 0 0 0 0 7 7 7 7 7 7 7 7 7 7 7 7 7 7 7 7 7 7 7 7 7 0 0 0 0 0 0 0 
0 0 0 0 0 0 0 0 0 0 0 0 0 0 0 0 0 0 0 0 0 0 0 0 0 0 0 0 0 0 0 0 0 0 0 0 0 0 0 0 0 0 0 0 0 0 0 0 7 0 0 0 0 0 0 0 0 0 0 0 0 0 0 0 0 0 0 0 7 0 0 0 0 0 0 0 
0 0 0 0 0 0 0 0 0 0 0 0 0 0 0 0 0 0 0 0 0 0 0 0 0 0 0 0 0 0 0 0 0 0 0 0 0 0 0 0 0 0 0 0 0 0 0 0 7 0 0 0 0 0 0 0 0 0 0 0 0 0 0 0 0 0 0 0 7 0 0 0 0 0 0 0 
0 0 0 0 0 0 0 0 0 0 0 0 0 0 0 0 0 0 0 0 0 0 0 0 0 0 0 0 0 0 0 0 0 0 0 0 0 0 0 0 0 0 0 0 0 0 0 0 7 0 0 0 0 0 0 0 0 0 0 0 0 0 0 0 0 0 0 0 7 0 0 0 0 0 0 0 
0 0 0 0 0 0 0 0 0 0 0 0 0 0 0 0 0 0 0 0 0 0 0 0 0 7 7 7 7 7 7 7 7 7 7 7 7 7 7 7 7 7 7 7 7 7 7 7 7 7 0 0 0 0 0 0 0 0 0 0 0 0 0 0 0 0 0 0 7 0 0 0 0 0 0 0 
0 0 0 0 0 0 0 0 0 0 0 0 0 0 0 0 0 0 0 0 0 0 0 0 0 9 0 0 0 0 0 0 7 0 0 0 0 0 0 0 0 7 0 0 0 0 0 0 0 8 0 0 0 0 0 0 0 0 0 0 0 0 0 0 0 0 0 0 7 7 7 0 0 0 0 0 
0 0 0 0 0 0 0 0 0 0 9 7 7 7 7 7 7 10 10 10 10 7 7 0 0 9 0 0 0 0 0 0 7 0 0 0 0 0 0 0 0 7 0 0 0 0 0 0 0 8 0 0 0 0 0 0 0 0 0 0 0 0 0 0 0 7 7 7 7 7 7 0 0 0 0 0 
0 0 0 0 0 0 0 0 0 0 9 6 6 6 6 6 7 6 6 6 6 6 8 0 0 9 0 0 0 0 0 0 7 0 0 0 0 0 0 0 0 7 0 0 0 0 0 0 0 8 7 7 7 7 7 7 7 7 7 7 7 9 10 10 10 8 6 6 6 13 7 0 0 0 0 0 
0 0 0 0 0 0 0 0 0 0 9 6 6 7 6 6 7 6 6 6 6 6 8 0 7 9 0 0 0 0 0 0 7 0 0 0 0 0 0 0 0 7 0 0 0 0 0 0 0 8 0 0 0 0 0 0 0 0 0 0 0 9 6 6 6 10 6 6 6 13 7 0 0 0 0 0 
0 0 0 0 0 0 0 0 0 0 9 13 13 7 10 10 7 6 6 6 6 6 8 7 7 10 0 0 0 0 0 0 7 0 0 0 0 0 0 0 0 7 0 0 0 0 0 0 0 8 0 0 0 0 0 0 0 0 0 0 0 9 6 6 6 10 6 6 7 7 7 0 0 0 0 0 
7 7 7 7 7 7 7 7 7 7 7 7 7 7 6 6 6 6 6 6 6 6 6 6 6 6 8 7 7 7 7 7 7 7 7 10 7 7 7 7 7 7 7 7 7 7 7 7 0 7 7 7 7 7 7 7 7 7 7 7 7 9 6 6 6 8 6 6 6 6 7 0 0 0 0 0 
9 6 6 6 6 7 6 6 6 6 6 6 6 6 6 6 6 6 6 6 6 6 6 6 6 6 6 6 6 6 6 6 6 6 10 6 6 6 6 6 6 6 6 6 6 6 6 6 6 6 6 6 6 6 6 6 6 6 6 6 6 6 6 6 6 8 8 7 7 7 7 7 7 7 7 7 
9 6 6 6 6 6 6 6 6 6 6 6 6 6 6 6 6 6 6 6 6 6 6 6 6 6 6 6 6 6 6 6 6 6 10 6 6 6 6 6 6 6 6 6 6 6 6 6 6 6 6 6 6 6 6 6 6 6 6 6 6 6 6 6 6 6 10 0 0 0 0 0 0 0 0 7 
9 6 6 6 8 9 6 6 7 7 9 6 6 8 9 6 6 6 6 6 6 6 6 6 6 6 6 6 6 6 6 6 6 6 10 6 6 6 6 6 6 6 6 6 6 6 6 6 6 6 6 6 6 6 6 6 6 6 6 6 6 6 6 6 6 6 8 0 0 0 0 0 0 0 0 7 
9 6 6 6 8 9 6 6 6 8 9 6 6 8 9 6 6 6 6 6 6 6 6 6 6 6 6 8 7 9 6 6 6 6 8 7 10 7 7 7 7 7 7 7 10 7 7 7 7 7 7 7 10 7 7 7 7 7 7 7 7 10 9 6 6 6 8 0 0 0 0 0 0 0 0 7
7 7 7 7 7 9 6 6 7 7 9 6 6 8 7 9 6 6 6 6 6 6 6 6 6 6 8 7 7 9 6 6 6 6 8 0 0 0 0 0 0 0 7 0 0 0 0 0 0 0 0 0 0 0 7 0 0 0 0 0 0 0 9 6 6 6 8 0 0 0 0 0 0 0 0 7 
9 6 6 6 6 6 6 6 6 8 9 6 6 8 7 7 7 7 7 7 10 10 7 7 7 7 7 7 7 9 6 6 6 6 8 0 0 0 0 0 0 0 7 0 0 0 0 0 0 0 0 0 0 0 7 0 0 0 0 0 0 0 9 6 6 6 8 0 0 0 0 0 0 0 0 7 
9 6 6 6 6 6 6 6 6 8 9 6 6 8 0 0 0 0 0 0 0 0 0 0 0 0 0 7 7 9 6 6 6 6 8 0 0 0 0 0 0 0 7 0 0 0 0 0 0 0 0 0 0 0 7 0 0 0 0 0 0 0 9 6 6 6 8 0 0 0 0 0 0 0 0 7 
9 6 6 6 6 6 6 6 6 8 9 6 6 8 0 0 0 0 0 0 0 0 0 0 0 0 0 7 7 9 6 6 6 6 8 0 0 0 0 0 0 0 7 0 0 0 0 0 0 0 0 0 0 0 7 0 0 0 0 0 0 0 9 6 6 6 8 0 0 0 0 0 0 0 0 7 
9 6 6 6 6 6 6 6 6 8 9 6 6 8 0 0 0 0 0 0 0 0 0 0 0 0 7 7 7 9 6 6 6 6 8 0 0 0 0 0 0 0 7 0 0 0 0 0 0 0 0 0 0 0 7 0 0 0 0 0 0 0 9 6 6 6 8 7 7 7 7 7 7 7 7 7
9 6 6 6 6 6 6 6 6 8 9 6 6 8 0 0 0 0 0 0 0 0 0 0 0 0 0 7 7 9 6 6 6 6 8 0 0 0 0 0 0 0 7 0 0 0 0 0 0 0 0 0 0 0 7 0 0 0 0 0 0 0 9 6 6 6 8 0 0 0 0 0 0 0 0 7 
9 6 6 6 6 6 6 6 6 8 9 6 6 8 0 0 0 0 0 0 0 0 0 0 0 0 0 7 7 9 6 6 6 6 8 0 0 0 0 0 0 0 7 0 0 0 0 0 0 0 0 0 0 0 7 0 0 0 0 0 0 0 9 6 6 6 10 0 0 0 0 0 0 0 0 7 
9 6 6 6 6 6 6 6 6 8 9 6 6 8 0 0 0 0 0 0 0 0 0 0 0 0 0 7 7 9 6 6 6 6 8 7 7 7 7 7 7 7 7 7 7 7 7 7 7 7 7 7 7 7 7 7 7 7 7 7 7 7 9 6 6 6 8 0 0 0 0 0 0 0 0 7 
7 7 7 6 6 7 7 7 7 7 9 6 6 8 0 0 0 0 0 0 0 0 0 0 0 0 0 7 7 9 6 6 6 6 8 0 0 0 0 0 0 0 7 0 0 0 0 0 0 0 0 0 0 0 7 0 0 0 0 0 0 0 9 6 6 6 8 0 0 0 0 0 0 0 0 7 
9 6 6 6 6 6 6 6 6 8 9 6 6 8 0 0 0 0 0 0 0 0 0 0 0 0 0 7 7 9 6 6 6 6 8 0 0 0 0 0 0 0 7 0 0 0 0 0 0 0 0 0 0 0 7 0 0 0 0 0 0 0 9 6 6 6 8 0 0 0 0 0 0 0 0 7 
9 6 6 6 6 6 6 6 6 8 9 6 6 8 0 0 0 0 0 0 0 0 0 0 0 0 0 7 7 9 6 6 6 6 8 0 0 0 0 0 0 0 7 0 0 0 0 0 0 0 0 0 0 0 7 0 0 0 0 0 0 0 9 6 6 6 8 0 0 0 0 0 0 0 0 7 
9 6 6 6 6 6 6 6 6 6 6 6 6 8 0 0 0 0 0 0 0 0 0 0 0 0 0 7 7 9 6 6 6 6 8 0 0 0 0 0 0 0 7 0 0 0 0 0 0 0 0 0 0 0 7 0 0 0 0 0 0 0 9 6 6 6 8 0 0 0 0 0 0 0 0 7 
9 6 6 6 6 6 6 6 6 8 9 6 6 8 0 0 0 0 0 0 0 0 0 0 0 0 0 7 7 9 6 6 6 6 8 0 0 0 0 0 0 0 7 0 0 0 0 0 0 0 0 0 0 0 7 0 0 0 0 0 0 0 9 6 6 6 8 0 0 0 0 0 0 0 0 7 
9 6 6 6 6 6 6 6 6 8 9 6 6 8 0 0 0 0 0 0 0 0 0 0 0 0 0 7 9 9 6 6 6 6 8 0 0 0 0 0 0 0 7 0 0 0 0 0 0 0 0 0 0 0 7 0 0 0 0 0 0 0 9 6 6 6 8 0 0 0 0 0 0 0 0 7 
7 7 7 7 7 7 7 7 7 7 9 6 6 8 0 0 0 0 0 0 0 0 0 0 0 0 0 9 9 6 6 6 6 6 8 0 0 0 0 0 0 0 7 0 0 0 0 0 0 0 0 0 0 0 7 0 0 0 0 0 0 0 9 6 6 6 8 0 0 0 0 0 0 0 0 7 
7 9 6 6 6 7 6 6 6 8 9 6 6 10 0 0 0 0 0 0 0 0 0 0 0 0 0 10 6 6 6 6 6 6 8 7 10 7 7 7 7 7 7 7 10 7 7 7 7 7 7 7 10 7 7 10 7 7 7 7 7 10 9 6 6 6 8 0 0 0 0 0 0 0 0 7 
0 9 6 6 6 7 7 7 6 8 9 6 6 8 0 0 0 0 0 0 0 0 0 0 0 0 0 9 9 6 6 6 6 6 10 6 6 6 6 6 6 6 6 6 6 6 6 6 6 6 6 6 6 6 6 6 6 6 6 6 6 6 6 6 6 6 10 0 0 0 0 0 0 0 0 7 
0 9 6 6 6 6 6 6 6 8 9 6 6 8 0 0 0 0 0 0 0 0 0 0 0 0 0 7 7 9 6 6 6 6 10 6 6 6 6 6 6 6 6 6 6 6 6 6 6 6 6 6 6 6 6 6 6 6 6 6 6 6 6 6 6 6 8 7 7 7 7 7 7 7 7 7 
0 9 6 6 6 6 6 6 6 8 6 6 6 8 0 0 0 0 0 0 0 0 0 0 0 0 0 7 7 9 6 6 6 6 10 6 6 6 6 6 6 6 6 6 6 6 6 6 6 6 6 6 6 6 6 6 6 6 6 6 6 6 6 6 6 6 10 0 0 0 0 0 0 0 0 7 
0 9 6 6 6 6 6 6 6 8 9 10 10 8 7 7 7 7 7 7 7 7 7 7 7 7 7 7 7 9 6 6 6 6 8 7 7 7 7 7 9 6 6 6 8 7 7 7 7 7 7 7 7 7 10 7 7 7 7 10 7 7 7 7 10 7 7 0 0 0 0 0 0 0 0 7 
7 7 7 7 7 7 7 7 7 7 9 6 6 10 0 0 0 0 0 0 0 0 0 0 0 0 0 0 10 6 6 6 6 6 8 0 0 0 0 9 6 6 6 6 8 7 0 0 0 0 0 0 0 0 0 0 7 7 0 0 0 0 0 0 0 0 7 0 0 0 0 0 0 0 0 7 
0 9 6 6 6 6 6 6 6 6 6 6 6 8 0 0 0 0 0 0 0 0 0 0 7 7 7 7 7 9 6 6 6 6 10 0 0 0 0 9 6 6 7 6 8 7 0 0 0 0 0 0 0 0 0 0 7 7 0 0 0 0 0 0 0 0 7 0 0 0 0 0 0 0 0 7 
0 9 6 6 6 6 6 6 6 6 6 6 6 8 0 0 0 0 0 0 0 0 0 0 7 0 0 0 0 9 6 6 6 6 8 0 0 0 0 9 6 6 7 6 8 7 0 0 0 0 0 0 0 0 0 0 7 7 0 0 0 0 0 0 0 0 7 0 0 0 0 0 0 0 0 7 
0 10 6 6 6 6 6 6 6 6 6 6 6 8 0 0 0 0 0 0 0 0 0 0 7 0 0 0 0 9 6 6 6 6 8 0 0 0 0 9 13 13 7 0 7 7 0 0 0 0 0 0 0 0 0 0 7 7 0 0 0 0 0 0 0 0 7 0 0 0 0 0 0 0 0 7 
0 10 6 6 6 6 6 6 6 6 6 6 6 8 0 0 0 0 0 0 0 0 0 0 7 0 0 0 7 9 6 6 6 6 8 7 7 7 7 7 0 0 0 0 7 7 7 7 7 7 7 7 7 7 7 7 7 7 0 0 0 0 0 0 0 0 7 0 0 0 0 0 0 0 0 7 
0 10 6 6 6 6 6 6 6 6 6 6 6 8 0 0 0 0 0 0 0 0 0 0 7 0 0 0 10 6 6 6 6 6 8 7 7 7 7 7 0 0 0 0 7 7 7 7 0 0 0 0 0 0 0 0 0 7 0 0 0 0 0 0 0 0 7 0 0 0 0 0 0 0 0 7 
0 10 6 6 6 6 6 6 6 6 6 6 6 8 7 7 7 7 7 7 7 7 7 7 7 7 7 7 7 9 10 10 10 10 8 7 7 7 7 7 7 7 7 7 7 7 7 7 0 0 0 0 0 0 0 0 0 7 7 7 7 7 7 7 7 7 7 7 7 7 7 7 7 7 7 7
0 9 6 6 6 6 6 6 6 6 6 6 6 6 6 6 6 6 6 6 6 6 6 6 6 6 6 6 6 6 6 6 6 6 6 6 6 6 6 6 6 6 6 6 6 6 6 8 0 0 0 0 0 0 0 0 0 7 0 0 0 0 0 0 0 0 0 0 0 0 0 0 0 0 0 0 
0 9 6 6 6 6 6 6 6 6 6 6 6 6 6 6 6 6 6 6 6 6 6 6 6 6 6 6 6 6 6 6 6 6 6 6 6 6 6 6 6 6 6 6 6 6 6 8 0 0 0 0 0 0 0 0 0 7 0 0 0 0 0 0 0 0 0 0 0 0 0 0 0 0 0 0 
0 9 6 6 6 6 6 6 6 6 6 6 6 6 6 6 6 6 6 6 6 6 6 6 6 6 6 6 6 6 6 6 6 6 6 6 6 6 6 6 6 6 6 6 6 6 6 8 0 0 0 0 0 0 0 0 0 7 0 0 0 0 0 0 0 0 0 0 0 0 0 0 0 0 0 0 
7 7 7 7 7 9 6 6 9 6 6 8 7 7 10 10 7 7 7 7 7 7 7 7 7 7 7 7 7 7 7 7 7 7 10 10 7 7 7 7 7 7 7 9 10 10 10 8 0 0 0 0 0 0 0 0 0 7 0 0 0 0 0 0 0 0 0 0 0 0 0 0 0 0 0 0 
7 0 0 0 0 9 6 6 9 6 6 8 0 0 0 0 0 0 0 0 0 0 0 0 0 0 0 0 0 0 0 0 0 0 0 0 0 7 0 0 0 0 0 9 6 6 6 8 0 0 0 0 0 0 0 0 0 7 0 0 0 0 0 0 0 0 0 0 0 0 0 0 0 0 0 0 
7 0 0 0 0 10 6 6 9 6 6 8 0 0 0 0 0 0 0 0 0 0 0 0 0 0 0 0 0 0 0 0 0 0 0 0 0 10 0 0 0 0 0 9 6 6 6 8 0 0 0 0 0 0 0 0 0 7 0 0 0 0 0 0 0 0 0 0 0 0 0 0 0 0 0 0 
7 0 0 0 0 10 6 6 9 6 6 8 0 0 0 0 0 0 0 0 0 0 0 0 0 0 0 0 0 0 0 0 0 0 0 0 0 7 0 0 0 0 0 9 6 6 6 8 0 0 0 0 0 0 0 0 0 7 0 0 0 0 0 0 0 0 0 0 0 0 0 0 0 0 0 0 
7 0 0 0 0 7 7 7 9 6 6 8 0 0 0 0 0 0 0 0 0 0 0 0 0 0 0 0 0 0 0 0 0 0 0 0 0 7 0 0 0 0 0 9 6 6 6 8 0 0 0 0 0 0 0 0 0 7 0 0 0 0 0 0 0 0 0 0 0 0 0 0 0 0 0 0 
7 0 0 0 0 0 0 0 9 6 6 8 0 0 0 0 0 0 0 0 0 0 0 0 0 0 0 0 0 0 0 0 0 0 0 0 0 7 0 0 0 0 0 9 6 6 6 10 0 0 0 0 0 0 0 0 0 7 0 0 0 0 0 0 0 0 0 0 0 0 0 0 0 0 0 0 
7 0 0 0 0 0 0 0 9 6 6 8 0 0 0 0 0 0 0 0 0 0 0 0 0 0 0 0 0 0 0 0 0 0 0 0 0 10 0 0 0 0 0 10 6 6 6 8 0 0 0 0 0 0 0 0 0 7 0 0 0 0 0 0 0 0 0 0 0 0 0 0 0 0 0 0 
7 0 0 0 0 0 0 0 9 6 6 8 0 0 0 0 0 0 0 0 0 0 0 0 0 0 0 0 0 0 0 0 0 0 0 0 0 7 0 0 0 0 0 9 6 6 6 8 0 0 0 0 0 0 0 0 0 7 0 0 0 0 0 0 0 0 0 0 0 0 0 0 0 0 0 0 
7 7 7 7 7 7 7 7 9 10 10 8 7 7 7 7 7 7 7 7 7 7 7 7 7 7 7 7 7 7 7 7 7 7 7 7 7 7 7 7 7 7 7 7 9 10 8 7 7 7 7 7 7 7 7 7 7 7 0 0 0 0 0 0 0 0 0 0 0 0 0 0 0 0 0 0
AreaSwitch 1279 1087 2 0 0
AreaSwitch 1350 1087 2 0 0
AreaSwitch 1790 2624 3 0 0
AreaDoor 2024 2491 50 0 0
Key 2024 2600 50 0 0