22 24
495 1375
9 7 7 7 7 7 7 7 7 7 7 7 7 7 7 8 0 0 0 0 0 0                                    
9 22 22 22 22 22 22 22 22 22 22 22 22 22 22 8 0 0 0 0 0 0
9 22 22 22 22 22 22 22 22 22 22 22 22 22 22 8 0 0 0 0 0 0 
9 7 7 7 22 22 22 22 22 22 22 22 7 7 7 8 0 0 0 0 0 0
9 22 22 22 22 22 22 22 22 22 22 22 22 22 22 8 0 0 0 0 0 0
9 22 22 7 22 22 22 22 22 22 22 22 7 22 22 8 0 0 0 0 0 0
9 2 2 7 7 7 7 7 7 7 7 7 7 2 2 8 0 0 0 0 0 0
9 2 2 2 2 2 2 2 2 2 2 2 2 2 2 8 0 0 0 0 0 0
9 27 2 2 2 2 2 2 2 2 2 2 2 2 27 8 0 0 0 0 0 0
9 27 2 2 27 27 27 27 27 27 27 27 2 2 27 8 0 0 0 0 0 0
9 27 2 2 27 27 27 27 27 27 27 27 2 2 27 8 0 0 0 0 0 0
9 2 2 2 2 2 2 2 2 2 2 2 2 2 2 8 0 0 0 0 0 0
9 27 2 2 27 27 27 27 27 27 27 27 2 2 27 8 0 0 0 0 0 0
9 2 2 2 2 2 2 2 2 2 2 2 2 2 2 8 0 0 0 0 0 0
9 27 2 2 27 27 27 27 27 27 27 27 2 2 27 8  0 0 0 0 0 0
9 2 2 2 2 2 2 2 2 2 2 2 2 2 2 8 0 0 0 0 0 0
9 27 2 2 27 27 27 27 27 27 27 27 2 2 27 8 0 0 0 0 0 0
9 2 2 2 2 2 2 2 2 2 2 2 2 2 2 8 0 0 0 0 0 0
9 27 2 2 27 27 7 7 7 7 27 27 2 2 27 8 0 0 0 0 0 0
9 2 2 2 2 2 7 2 2 7 2 2 2 2 2 8 0 0 0 0 0 0
9 27 2 2 27 27 7 2 2 7 27 27 2 2 27 8 0 0 0 0 0 0
9 2 2 2 7 7 7 2 2 7 7 7 2 2 2 8 0 0 0 0 0 0
9 2 2 2 2 2 2 2 2 2 2 2 2 2 2 8 0 0 0 0 0 0
9 7 7 7 7 7 7 10 10 7 7 7 7 7 7 8 0 0 0 0 0 0
AreaSwitchExact 448 1472 1 1325 1000
AreaSwitchExact 512 1472 1 1325 1000