23 21
898 800
0 0 0 0 0 0 0 0 0 0 0 0 0 0 0 0 0 0 0 0 0 0 0
0 0 0 0 0 0 0 0 0 0 0 0 0 0 0 0 0 0 0 0 0 0 0
0 0 0 0 0 0 0 0 0 0 0 0 0 0 0 0 0 0 0 0 0 0 0
0 0 0 0 0 0 0 0 0 0 0 0 0 0 0 0 0 0 0 0 0 0 0
0 0 0 0 0 0 0 0 0 0 0 0 0 0 0 0 0 0 0 0 0 0 0
0 0 0 0 0 0 0 7 7 7 7 7 7 7 7 7 0 0 0 0 0 0 0
0 0 0 0 0 0 0 9 21 21 21 21 21 21 21 8 0 0 0 0 0 0 0
0 0 0 0 0 0 0 9 21 21 21 21 21 21 21 8 0 0 0 0 0 0 0
0 0 0 0 0 0 0 9 21 21 21 21 21 21 21 8 0 0 0 0 0 0 0
0 0 0 0 0 0 0 9 21 21 21 21 21 21 21 8 0 0 0 0 0 0 0
0 0 0 0 0 0 0 9 21 21 21 21 21 21 21 8 0 0 0 0 0 0 0
0 0 0 0 0 0 0 9 21 21 21 21 21 21 21 8 0 0 0 0 0 0 0
0 0 0 0 0 0 0 9 21 21 21 21 21 31 21 8 0 0 0 0 0 0 0
0 0 0 0 0 0 0 9 21 21 21 21 21 31 21 21 0 0 0 0 0 0 0
0 0 0 0 0 0 0 7 7 7 7 7 7 7 7 7 0 0 0 0 0 0 0
0 0 0 0 0 0 0 0 0 0 0 0 0 0 0 0 0 0 0 0 0 0 0
0 0 0 0 0 0 0 0 0 0 0 0 0 0 0 0 0 0 0 0 0 0 0
0 0 0 0 0 0 0 0 0 0 0 0 0 0 0 0 0 0 0 0 0 0 0
0 0 0 0 0 0 0 0 0 0 0 0 0 0 0 0 0 0 0 0 0 0 0
0 0 0 0 0 0 0 0 0 0 0 0 0 0 0 0 0 0 0 0 0 0 0
0 0 0 0 0 0 0 0 0 0 0 0 0 0 0 0 0 0 0 0 0 0 0
AreaSwitchExact 960 833 1 1935 2590