23 21
879 791
0 0 0 0 0 0 0 0 0 0 0 0 0 0 0 0 0 0 0 0 0 0 0
0 0 0 0 0 0 0 0 0 0 0 0 0 0 0 0 0 0 0 0 0 0 0
0 0 0 0 0 0 0 0 0 0 0 0 0 0 0 0 0 0 0 0 0 0 0
0 0 0 0 0 0 0 0 0 0 0 0 0 0 0 0 0 0 0 0 0 0 0
0 0 0 0 0 0 0 0 0 0 0 0 0 0 0 0 0 0 0 0 0 0 0
0 0 0 0 0 0 0 30 7 7 7 7 7 7 7 32 0 0 0 0 0 0 0
0 0 0 0 0 0 0 9 21 21 21 21 21 21 21 8 0 0 0 0 0 0 0
0 0 0 0 0 0 0 9 21 21 21 21 21 21 21 8 0 0 0 0 0 0 0
0 0 0 0 0 0 0 9 21 21 21 21 21 21 21 8 0 0 0 0 0 0 0
0 0 0 0 0 0 0 9 21 21 21 21 21 21 21 8 0 0 0 0 0 0 0
0 0 0 0 0 0 0 9 21 21 21 21 21 21 21 8 0 0 0 0 0 0 0
0 0 0 0 0 0 0 9 21 21 21 21 21 21 21 8 0 0 0 0 0 0 0
0 0 0 0 0 0 0 9 21 21 21 21 21 21 21 8 0 0 0 0 0 0 0
0 0 0 0 0 0 0 9 28 28 28 28 28 21 21 21 0 0 0 0 0 0 0
0 0 0 0 0 0 0 31 7 7 7 7 7 7 7 33 0 0 0 0 0 0 0
0 0 0 0 0 0 0 0 0 0 0 0 0 0 0 0 0 0 0 0 0 0 0
0 0 0 0 0 0 0 0 0 0 0 0 0 0 0 0 0 0 0 0 0 0 0
0 0 0 0 0 0 0 0 0 0 0 0 0 0 0 0 0 0 0 0 0 0 0
0 0 0 0 0 0 0 0 0 0 0 0 0 0 0 0 0 0 0 0 0 0 0
0 0 0 0 0 0 0 0 0 0 0 0 0 0 0 0 0 0 0 0 0 0 0
0 0 0 0 0 0 0 0 0 0 0 0 0 0 0 0 0 0 0 0 0 0 0
AreaSwitchExact 960 833 1 1935 2590